type	era5fb	<class 'numpy.int32'>
class	era5fb	<class 'numpy.int32'>
stream	era5fb	<class 'numpy.int32'>
andate	era5fb	<class 'numpy.int32'>
antime	era5fb	<class 'numpy.int32'>
reportype	era5fb	<class 'numpy.int32'>
numtsl@desc	era5fb	<class 'numpy.int32'>
timeslot@timeslot_index	era5fb	<class 'numpy.int32'>
seqno@hdr	era5fb	<class 'numpy.int32'>
bufrtype@hdr	era5fb	<class 'numpy.int32'>
subtype@hdr	era5fb	<class 'numpy.int32'>
groupid@hdr	era5fb	<class 'numpy.int32'>
obstype@hdr	era5fb	<class 'numpy.int32'>
codetype@hdr	era5fb	<class 'numpy.int32'>
sensor@hdr	era5fb	<class 'numpy.float32'>
date@hdr	era5fb	<class 'numpy.int32'>
time@hdr	era5fb	<class 'numpy.int32'>
report_status@hdr	era5fb	<class 'numpy.int32'>
lat@hdr	era5fb	<class 'numpy.float64'>
lon@hdr	era5fb	<class 'numpy.float64'>
lsm@modsurf	era5fb	<class 'numpy.float32'>
orography@modsurf	era5fb	<class 'numpy.float32'>
windspeed10m@modsurf	era5fb	<class 'numpy.float32'>
tsfc@modsurf	era5fb	<class 'numpy.float32'>
albedo@modsurf	era5fb	<class 'numpy.float32'>
seaice@modsurf	era5fb	<class 'numpy.float32'>
snow_depth@modsurf	era5fb	<class 'numpy.float32'>
sonde_type@conv	era5fb	<class 'numpy.float32'>
entryno@body	era5fb	<class 'numpy.int32'>
obsvalue@body	era5fb	<class 'numpy.float32'>
varno@body	era5fb	<class 'numpy.int32'>
vertco_type@body	era5fb	<class 'numpy.int32'>
vertco_reference_1@body	era5fb	<class 'numpy.float64'>
vertco_reference_2@body	era5fb	<class 'numpy.float32'>
ppcode@conv_body	era5fb	<class 'numpy.float32'>
datum_status@body	era5fb	<class 'numpy.int32'>
biascorr@body	era5fb	<class 'numpy.float32'>
biascorr_fg@body	era5fb	<class 'numpy.float32'>
varbc_ix@body	era5fb	<class 'numpy.int32'>
qc_pge@body	era5fb	<class 'numpy.float32'>
an_depar@body	era5fb	<class 'numpy.float32'>
an_sens_obs@body	era5fb	<class 'numpy.float32'>
fg_depar@body	era5fb	<class 'numpy.float32'>
an_depar@surfbody_feedback	era5fb	<class 'numpy.float32'>
fg_depar@surfbody_feedback	era5fb	<class 'numpy.float32'>
snow_depth@surfbody_feedback	era5fb	<class 'numpy.float32'>
snow_density@surfbody_feedback	era5fb	<class 'numpy.float32'>
datum_status@surfbody_feedback	era5fb	<class 'numpy.int32'>
datum_sfc_event@surfbody_feedback	era5fb	<class 'numpy.int32'>
lsm@surfbody_feedback	era5fb	<class 'numpy.float32'>
stalt@hdr	era5fb	<class 'numpy.float32'>
obs_error@errstat	era5fb	<class 'numpy.float32'>
final_obs_error@errstat	era5fb	<class 'numpy.float32'>
fg_error@errstat	era5fb	<class 'numpy.float32'>
eda_spread@errstat	era5fb	<class 'numpy.float32'>
expver	era5fb	<class 'numpy.bytes_'>
source@hdr	era5fb	<class 'numpy.bytes_'>
statid@hdr	era5fb	<class 'numpy.bytes_'>
source_id	era5fb	<class 'numpy.bytes_'>
scheme	id_scheme	<class 'numpy.int64'>
description	id_scheme	<class 'str'>
crs	crs	<class 'numpy.int64'>
variable	observed_variable	<class 'str'>
parameter_group	observed_variable	<class 'str'>
domain	observed_variable	<class 'str'>
sub_domain	observed_variable	<class 'str'>
name	observed_variable	<class 'str'>
units	observed_variable	<class 'str'>
primary_id	station_configuration	<class 'numpy.bytes_'>
primary_id_scheme	station_configuration	<class 'numpy.int64'>
record_number	station_configuration	<class 'numpy.int64'>
secondary_id	station_configuration	<class 'numpy.bytes_'>
secondary_id_scheme	station_configuration	<class 'numpy.int64'>
station_name	station_configuration	<class 'numpy.bytes_'>
station_abbreviation	station_configuration	<class 'numpy.bytes_'>
alternative_name	station_configuration	<class 'numpy.bytes_'>
station_crs	station_configuration	<class 'numpy.int64'>
longitude	station_configuration	<class 'numpy.float64'>
latitude	station_configuration	<class 'numpy.float64'>
local_gravity	station_configuration	<class 'numpy.bytes_'>
start_date	station_configuration	<class 'numpy.int64'>
end_date	station_configuration	<class 'numpy.int64'>
station_type	station_configuration	<class 'numpy.int64'>
platform_type	station_configuration	<class 'numpy.int64'>
platform_sub_type	station_configuration	<class 'numpy.int64'>
operating_institute	station_configuration	<class 'numpy.bytes_'>
operating_territory	station_configuration	<class 'numpy.bytes_'>
city	station_configuration	<class 'numpy.bytes_'>
contact	station_configuration	<class 'numpy.bytes_'>
role	station_configuration	<class 'numpy.bytes_'>
observing_frequency	station_configuration	<class 'numpy.bytes_'>
reporting_time	station_configuration	<class 'numpy.bytes_'>
telecommunication_method	station_configuration	<class 'numpy.bytes_'>
station_automation	station_configuration	<class 'numpy.bytes_'>
measuring_system_model	station_configuration	<class 'numpy.bytes_'>
measuring_system_id	station_configuration	<class 'numpy.bytes_'>
observed_variables	station_configuration	<class 'numpy.bytes_'>
comment	station_configuration	<class 'numpy.bytes_'>
optional_data	station_configuration	<class 'numpy.bytes_'>
bbox_min_longitude	station_configuration	<class 'numpy.bytes_'>
bbox_max_longitude	station_configuration	<class 'numpy.bytes_'>
bbox_min_latitude	station_configuration	<class 'numpy.bytes_'>
bbox_max_latitude	station_configuration	<class 'numpy.bytes_'>
metadata_contact	station_configuration	<class 'numpy.bytes_'>
metadata_contact_role	station_configuration	<class 'numpy.int64'>
field_id	station_configuration_codes	<class 'str'>
field_name	station_configuration_codes	<class 'str'>
code_value	station_configuration_codes	<class 'str'>
abbreviation	station_configuration_codes	<class 'str'>
observation_id	observations_table	<class 'numpy.bytes_'>
report_id	observations_table	<class 'numpy.bytes_'>
data_policy_licence	observations_table	<class 'numpy.int32'>
date_time	observations_table	<class 'numpy.int64'>
date_time_meaning	observations_table	<class 'numpy.int32'>
observation_duration	observations_table	<class 'numpy.int32'>
z_coordinate	observations_table	<class 'numpy.float64'>
reference_z_coordinate	observations_table	<class 'numpy.float32'>
z_coordinate_type	observations_table	<class 'numpy.int32'>
observation_height_above_station_surface	observations_table	<class 'numpy.float32'>
observed_variable	observations_table	<class 'numpy.int64'>
secondary_variable	observations_table	<class 'numpy.int32'>
observation_value	observations_table	<class 'numpy.float32'>
value_significance	observations_table	<class 'numpy.int32'>
secondary_value	observations_table	<class 'numpy.int32'>
code_table	observations_table	<class 'numpy.int32'>
conversion_flag	observations_table	<class 'numpy.int32'>
location_method	observations_table	<class 'numpy.int32'>
location_precision	observations_table	<class 'numpy.float32'>
z_coordinate_method	observations_table	<class 'numpy.int32'>
spatial_representativeness	observations_table	<class 'numpy.int32'>
quality_flag	observations_table	<class 'numpy.int32'>
numerical_precision	observations_table	<class 'numpy.float32'>
sensor_id	observations_table	<class 'numpy.bytes_'>
reference_sensor_id	observations_table	<class 'numpy.bytes_'>
sensor_automation_status	observations_table	<class 'numpy.int32'>
exposure_of_sensor	observations_table	<class 'numpy.int32'>
original_precision	observations_table	<class 'numpy.float32'>
original_units	observations_table	<class 'numpy.int32'>
original_code_table	observations_table	<class 'numpy.int32'>
original_value	observations_table	<class 'numpy.float32'>
conversion_method	observations_table	<class 'numpy.int32'>
processing_code	observations_table	<class 'float'>
processing_level	observations_table	<class 'numpy.int32'>
adjustment_id	observations_table	<class 'numpy.bytes_'>
traceability	observations_table	<class 'numpy.int32'>
advanced_qc	observations_table	<class 'numpy.int32'>
advanced_uncertainty	observations_table	<class 'numpy.int32'>
advanced_homogenisation	observations_table	<class 'numpy.int32'>
advanced_assimilation_feedback	observations_table	<class 'numpy.int32'>
report_id	header_table	<class 'numpy.bytes_'>
region	header_table	<class 'numpy.int32'>
sub_region	header_table	<class 'numpy.int32'>
application_area	header_table	<class 'float'>
observing_programme	header_table	<class 'float'>
report_type	header_table	<class 'numpy.int32'>
primary_station_id	header_table	<class 'numpy.bytes_'>
station_record_number	header_table	<class 'numpy.int32'>
primary_station_id_scheme	header_table	<class 'numpy.int32'>
location_accuracy	header_table	<class 'numpy.float32'>
location_method	header_table	<class 'numpy.int32'>
location_quality	header_table	<class 'numpy.int32'>
station_speed	header_table	<class 'numpy.float32'>
station_course	header_table	<class 'numpy.float32'>
station_heading	header_table	<class 'numpy.float32'>
height_of_station_above_local_ground	header_table	<class 'numpy.float32'>
height_of_station_above_sea_level	header_table	<class 'numpy.float32'>
height_of_station_above_sea_level_accuracy	header_table	<class 'numpy.float32'>
sea_level_datum	header_table	<class 'numpy.int32'>
report_meaning_of_timestamp	header_table	<class 'numpy.int32'>
report_timestamp	header_table	<class 'numpy.int64'>
report_duration	header_table	<class 'numpy.int32'>
report_time_accuracy	header_table	<class 'numpy.float32'>
report_time_quality	header_table	<class 'numpy.int32'>
report_time_reference	header_table	<class 'numpy.int32'>
profile_id	header_table	<class 'numpy.bytes_'>
events_at_station	header_table	<class 'float'>
report_quality	header_table	<class 'numpy.int32'>
duplicate_status	header_table	<class 'numpy.int32'>
duplicates	header_table	<class 'float'>
record_timestamp	header_table	<class 'numpy.int64'>
history	header_table	<class 'numpy.bytes_'>
processing_level	header_table	<class 'numpy.int32'>
processing_codes	header_table	<class 'float'>
source_record_id	header_table	<class 'numpy.bytes_'>
number_of_pressure_levels	header_table	<class 'numpy.int32'>
report_synoptic_time	header_table	<class 'numpy.int64'>
product_version	header_table	<class 'numpy.int32'>
comments	header_table	<class 'numpy.bytes_'>
owner	header_table	<class 'numpy.bytes_'>
references	header_table	<class 'numpy.bytes_'>
instrument	header_table	<class 'numpy.bytes_'>
product_name	header_table	<class 'numpy.bytes_'>
source_file	source_configuration	<class 'numpy.str_'>
base_units	units	<class 'str'>
station_type@conv	era5fb	<class 'numpy.float32'>
collection_identifier@conv	era5fb	<class 'numpy.int32'>
unique_identifier@conv	era5fb	<class 'numpy.int32'>
station_type@conv	era5fb	<class 'numpy.float32'>
collection_identifier@conv	era5fb	<class 'numpy.int32'>
timeseries_index@conv	era5fb	<class 'numpy.int32'>
unique_identifier@conv	era5fb	<class 'numpy.int32'>
type@desc	era5fb	<class 'numpy.int32'>
class@desc	era5fb	<class 'numpy.int32'>
stream@desc	era5fb	<class 'numpy.int32'>
andate@desc	era5fb	<class 'numpy.int32'>
antime@desc	era5fb	<class 'numpy.int32'>
reportype@hdr	era5fb	<class 'numpy.int32'>
sondetype@conv	era5fb	<class 'numpy.int32'>
expver@desc	era5fb	<class 'numpy.bytes_'>
